누군가	NP
메타포	NNG
무언가	NP
버킷리스트	NNG
변주	NNG
불안정	NNG
불안정	XR
실	NNG
실험	NNG
실험성	NNG
알싸	XR
약소국	NNG
약소국가	NNG
애널리스트 	NNG
앱	NNG
완독	NNG
워라밸	NNG
유에스비	NNG
유튜브	NNG
유튜버	NNG
작품상	NNG
재밋거리	NNG
정	NNG
정도	NNG
주변인	NNG
존재감	NNG
죗값	NNG
지나	VV
지난	XR
질풍노도	NNG
최고조	NNG
최우수	NNG
파라다이스	NNG
핑곗거리	NNG
하굣길	NNG
하교길	NNG
하나	NR
형상화	NNG
개츠비	NNP
라푼첼	NNP
리델	NNP
소세키	NNP
을사늑약	NNP
청나라	NNP
